#############
#!!!!!!     #
#!##### &# &#
#!# & & & & #
#!# & ###& &#
#   & & & & !#
# &##     &!!#
# &@&   & #!!#
# &&###&###!!#
#       !!!!!#
##############