###########\n
#         #\n
#  # & #  #\n
#  !& &!  #\n
# !!#& #! #\n
#  !& &!  #\n
#  # & #  #\n
#@        #\n
###########\n level3

