#############
#           #
# && & & &  ###
#  &########  #
#   #!!!!!!!& #
# #&&!!!!!!#  #
#@  # ## ### ##
### #  #      #
#    & #   &  #
# #&#& ###    #
#   #  # ######
########