###########
#!! ! ! !!#
# &&&@&&& #
# & ### & #
#  !# #!  #
##### #####