  #########
  #!!!!!!!########
  #!!!!!!!   #   ##
#######   #& # && #
# &      &   #    #
# &##  # ### # &&##
#   && #!! # #   #
#    & #!!!#&# &&#
# &&&  #! !  &   #
#  &@& ##&#& #   #
######      ######
     ########